11111111
10000011
1PE0C011
11111111
